
NO0./textures/eagle.xpm0000
SO0./textures/eagle.xpm
WE ./textures/eagle.xpm   
EA ./textures/eagle.xpm
F 220,100,0
C 0,10,150
SC 50


0000000001111111111
00000000010000000001
11111111110000000011111110
10000000000000000000000010
10000000000010000000000010
10000000000000000000000010
10000000000000000000000010
100000000000N0000000000011111111111111111111111111110
10000000000000000000000010000000000000000000000000000
10000000000000000000000010000000000000000000000000001
10000000000010000000000011111111111110000000111111111111110
100000000000000000000000100000000000100000001
111111111111111111111111100000000000100000001
000000000000000000000000000000000000111111111
