
NO ./textures/eagle.xpm    
SO ./textures/eagle.xpm
WE ./textures/eagle.xpm   
EA ./textures/eagle.xpm

F 220,100,0
C 0,10,150
SC 50

11111
10001
10N01
10001
11111
