
NO ./textures/eagle.xpm    
SO ./textures/eagle.xpm
WE ./textures/eagle.xpm   
EA ./textures/eagle.xpm
F 220,100,0
C 0,10,150
SC 50


1111 11111
10N0100001
1000000001
1111011111
1000000011
1111011111


