
NO ./textures/north.xpm    
SO ./textures/south.xpm
WE ./textures/south.xpm  
EA ./textures/east.xpm

F 220,100,0
C 0,10,150
SC 50

11111111111111
10000000000001
10000000000001
10000000000001
10000000000001
100000N0000001
10000000000001
10000000000001
10000000000001
10000000000001
10000000000001
11111111111111
