
NO ./textures/north.xpm    
SO ./textures/south.xpm
WE ./textures/south.xpm  
EA ./textures/east.xpm

F 64,64,64
C 64,64,64
SC 50

11111111111111
10000000000001
10111111111101
10000000000001
10000000000001
10000000000001
10000000000001
10000000000001
10000000000001
10000000000001
10000000000001
10000000000001
10000000000001
10000000000001
10000000000001
10000000000001
10000000000001
1000000N0000001
10000000000001
1000000000001
10000000000011
100000100000101
101000000011001
10000000000001
10000000000001
10000000000001
10000000000001
10000000000001
10000000000001
10000000000001
10000000000001
10000000000001
10000000000001
10000000000001
10000000000001
11111111111111
