1111111111111111111111111 
1            1           11
1           11            01
1            1          111
1            1          1 
1           N1          1 
1            1          1 
1            1          1 
1           11          01
1111111        1          1 
     1111111111111111111111111 

NO ./textures/eagle.xpm    
SO ./textures/eagle.xpm
WE ./textures/eagle.xpm   
EA ./textures/eagle.xpm
F 220,100,0
C 0,10,150
SC 50