NO ./textures/wall_4.xpm
SO ./textures/wall_4.xpm
WE ./textures/wall_4.xpm
EA ./textures/wall_4.xpm

F 220,100,0
C 0,10,150

        1111111111111111111111111
        1000000000110000000000001
        1011000001110000000000001
        1001000000000000000000001
111111111011000001110000000000001
100000000011000001110111111111111
111101    111011100000010001
11110111111111011101010010001
11000000111101011100000010001
100000001   10S00001100000010001
100000001   10000001101010010001
110000011   1010101111101111000111
111101111   1110101 101111010001
111111111   1111111 111111111111
