
NO ./textures/walls/telep.xpm
SO ./textures/walls/telep.xpm
WE ./textures/walls/telep.xpm
EA ./textures/walls/telep.xpm

F ./textures/walls/wood.xpm
C ./textures/walls/ceil.xpm

111111112111111111111
100000000000000000001111111111111111
104000001111110000000000000000000001
100000000000000000011111111111111111
103000400111111000000000000000000N001
10000000100001000      0000000000001
1000300100001000           000000001
100000001111110000000000000000000001
10000000000000000001111111111111111
111111111111111111111
