
NO ./textures/stone4.xpm
SO ./textures/stone4.xpm
WE ./textures/stone4.xpm
EA ./textures/stone4.xpm

F ./textures/stone4.xpm
C ./textures/stone4.xpm

111111111111111111111
100000000000000000001111111111111111
100000001111110000000000000000000001
100N0000100001000      0000000000001
10000000100001000           00000001
100000001111110000000000000000000001
100000000000000000001111111111111111
111111111111111111111
