
NO ./textures/painting.xpm
SO ./textures/painting.xpm
WE ./textures/painting.xpm
EA ./textures/painting.xpm

F ./textures/north.xpm
C ./textures/east.xpm

111111111111111111111
101000001000000000001
101010101011111110001
100010100010000010001
111110101111101011101
100000101000101000001
101111101011101111111
101000001010100000101
101011111010111110101
101010001010100010101
101110101010101010101
100000101010001010001
111111101111111011101
100000101100000010001
101110101110101110111
101000100100100010101
101000000000000010101
100011000000000010001
101011000W00000000001
100000000000000000001
111111111111111111111
