
NO ./textures/north.xpm    
SO ./textures/south.xpm
WE ./textures/south.xpm  
EA ./textures/east.xpm

F ./textures/east.xpm
C ./textures/east.xpm

111111111111111111111
101000001000000000001
100000000000000000001
100000000000000000001
100000000000000000001
100000000000000000001
100000000000000000001
100000000000000000001
10000000000E000000001
100000000000000000001
100000000000000000001
100000000000000000001
100000000000000000001
100000000000000000001
100000000000000000001
100000000000000000001
101000001000000000001
111111111111111111111
