
NO ./textures/walls/telep.xpm
SO ./textures/walls/telep.xpm
WE ./textures/walls/telep.xpm
EA ./textures/walls/telep.xpm

F ./textures/walls/wood.xpm
C ./textures/walls/ceil.xpm


1111211111111111111111111111111111111
140000000111111000000000000000000001
10000000100001000      0000000000001
1000300100001000           000000001
100000001111110000000000000000000001
10000S00000000000001111111111111111
111111111111111111111111111111111111
111111111111111111111111111111111111