
NO ./textures/painting.xpm
SO ./textures/painting.xpm
WE ./textures/painting.xpm
EA ./textures/painting.xpm

F ./textures/north.xpm
C ./textures/east.xpm

111111111111111111111
100000000000000000001
100000001111110000001
100W00001000010000001
100000001000010000001
100000001111110000001
100000000000000000001
111111111111111111111
