NO ./textures/eagle.xpm    
SO ./textures/eagle.xpm
WE ./textures/eagle.xpm   
EA ./textures/eagle.xpm

F 0,0,0 
C 65,102,106

        1111111111111111111111111
        1000000000110000000000001
        1011000001110000000000001
        1001000000000000000001101
111111111011000001110000000000001
100000000011000001110111110111111
11110111111111011100010010001
11110111111111011100000110001
11001000110101011101100101001
1000000011000001100011010001
1000000001110001101010010001
1100000111010101111101111001111
11110111 1110101 10111101000N1
11111111 1111111 111111111111